%%%%%%%%%%%%%%%%%%%%%%%%%%%%%%%%%%%%%
%P                                  %
% %                                 %
% %                                 %
% %                                 %
% %                                 %
%%                                  %
%                                   %
%                                   %
%                                   %
%                                   %
%                                   %
%                                   %
%                                   %
%                                   %
%                                   %
%                                   %
%                                   %
%                                   %
%%%%%%%%%%%%%%%%%%%%%%%%%%%%%%%%%%%%%